Абсентеизм — В науке конституционного права термин, означающий добровольное неучастие избирателей в голосовании на выборах или референдуме.

Авторитарный — Основанный на личной власти, личной диктатуре

Авторитет — Влияние, основанное на знаниях, нравственных достоинствах, опыте

Адаптация — приспособление к физической или социальной среде

Анимизм — раннее религиозное верование в существование духов и души

Аномия — состояние общественного сознания, которое характеризуется разложением системы ценностей в результате кризиса общества, противоречий между провозглашёнными целями и невозможностью их реализовать

Асоциальный — направленный против общества

Ассимиляция — этническое поглощение, почти полное растворение одного народа в другом

Атрибут — необходимое существенное свойство

Бедность — экономическое и социальное состояние людей, имеющих минимальный доход, уровень образования, власти и престиж

Безработица — незанятость трудоспособного населения в общественном производстве материальных и духовных ценностей

Безработный — человек, не имеющий заработка, стоящий на учёте в службе занятости и получающий специальное пособие по безработице

Белые воротнички — работники, занятые в автоматизированном производстве, научных и прикладных разработках, в сфере информации. Благо — всё, что способно удовлетворить повседневные потребности людей

Богатство — денежная сумма, выражающая стоимость движимой и недвижимой собственности человека

Брак — добровольный равноправный союз мужчины и женщины, заключённый в установленном порядке с целью создания семьи

Бюджет — финансовый план, который суммирует доходы и расходы за определённый период времени

Бюрократия — социальный слой профессиональных управленцев, включённых в организационную структуру, характеризующуюся чёткой иерархией, «вертикальными» информационными потоками, формализованными способами принятия решений и претензией на особый статус в обществе

Владение — фактическое обладание имуществом

Власть — влияние на основе закона или традиции, подчинение людей, возможность навязывать свою волю или решения другим людям независимо от их желания

Генотип — генетическая (наследственная) конституция организма, совокупность всех его генов, устойчивых черт, благодаря передаче из поколения в поколение сохраняется биологическая сущность народа или этноса

Глобализация — исторический процесс сближения наций и народов, между которыми постепенно стираются традиционные границы, и человечество превращается в единую политическую систему

Государственный бюджет — финансовый документ, расписывающий доходы и расходы государства на определённый период (на год)

Государство — это особая организация публичной политической власти господствующего класса (социальной группы, всего народа), располагающая специальным аппаратом принуждения, осуществляющая руководство обществом и представляющая его на международной арене

Гражданское общество — это самоорганизующаяся система естественно складывающихся отношений между индивидами, где каждый выступает не как подданный государства, а как частное лицо, имеющее свои особенные жизненные цели

Девиантное поведение — асоциальный тип поведения, противоречащий социальным нормам

Дееспособность — это способность индивида самостоятельно осуществлять свои права и нести обязанности

Деньги — средство обмена, всеобщий эквивалент

Дефицит — недостаточность средств или ресурсов в сравнении с ранее намечавшимся, запланированным или необходимым уровнем

Договор — соглашение между людьми, организациями, государствами

Досуг — часть свободного времени, которым человек располагает по собственному усмотрению

Доход — любая сумма денег, полученных в виде зарплаты, пенсий, пособий, алиментов, гонораров

Закрытое общество — общество, где социальные перемещения из низших страт в высшие либо вообще запрещены, либо существенно ограничены

Заработная плата — цена за труд, измеряемая в единицу времени

Иерархия — расположение частей или элементов целого в порядке от высшего к низшему

Избирательное плата — совокупность правовых норм, устанавливающих порядок выборов органов государственной власти и местного самоуправления

Изобразительное искусство — раздел пластических искусств, объединяющий живопись, скульптуру, графику

Имидж — совокупность представлений, сложившихся в общественном мнении, о том, как должен вести себя человек в соответствии со своим социальным статусом, как должны соотноситься между собой права и обязанности в данном статусе

Импичмент — особый порядок привлечения к ответственности и судебного рассмотрения дел о преступлениях высших должностных лиц

Имущественные отношения — правоотношения по поводу материальных благ

Инвестиции — долгосрочные вложения капитала в отрасли экономики внутри страны и за границей

Индивидуализм — идеология признания приоритета личных интересов над общественными; совокупность идей и принципов, по которым благо человека, его свобода и личностное развитие являются высшей целью, а функционирование различных институтов и групп — основой и средством для достижения этой цели

Индивидуальность — сочетание психологических особенностей человека, составляющих его своеобразие, отличие от других людей

Индивидуум — отдельный человек

Информационное общество — постиндустриальное общество, в котором основной производительной силой выступают знания и информация

Искусство — 1) художественное творчество в целом: литература, архитек- тура, скульптура, живопись, театр, кино и другие разновидности человеческой деятельности, объединяемые в качестве художественнообразных форм освоения мира; 2) только изобразительное искусство; 3) высокая степень умения, мастерства в любой сфере деятельности

Капитализм — общество, основанное на частной собственности и свободных рыночных отношениях

Каста — социальная группа людей, членству в которой человек обязан исключительно своим рождением

Конкуренция — открытое соперничество людей, групп или организаций в достижении сходных целей, лучших результатов в определённой общественной сфере

Конституция — основной закон государства, определяющий его общественное и государственное устройство, порядок, принципы образования представительных органов власти, избирательную систему, основные права и обязанности граждан

Конфликт — это столкновение, спор людей или социальных групп за обладание властью, материальными или духовными ценностями

Коррупция — прямое использование должностным лицом своего служебного положения в целях личного обогащения

Косвенный налог — сбор в пользу государства, взимаемый с граждан или хозяйственных организаций только при осуществлении ими определённых действий, например, при покупке некоторых видов товаров

Культ — действия (телодвижения, чтение, пение определённых текстов), имеющие целью дать видимое выражение религиозному поклонению или привлечь к их совершителям божественную силу

Культура — (возделывание, воспитание, образование, развитие, почитание) — совокупность традиций, обычаев, социальных норм, материальных и духовных ценностей, передаваемых из поколения в поколение

Лидер — активный, пользующийся максимальным авторитетом член группы, наиболее ярко выражающий её интересы и представляющий группу в различных общественных организациях

Манеры — внешние формы поведения людей, получающие положительную или отрицательную оценку окружающих; отличительные черты поведения

Маргинал — человек, покинувший одну культуру, страну, класс, группу и не приобщившийся к ценностям и образу жизни другой

Мировоззрение — совокупность взглядов человека на мир и его место в нём

Многопартийность — партийная система, при которой в стране существуют и легально действуют более двух политических партий

Мораль — совокупность нравственных норм, получивших идейное обоснование в виде идеалов добра и зла, должного, справедливого; исполнение норм морали поддерживается силой общественного мнения; мораль включает непреходящие духовные ценности, а также исторически преходящие нормы и идеалы; изучается специальной философской дисциплиной —

этикой

Мотив — разумно объяснённая причина поведения, осмысленное действие

Налоги — обязательные платежи, взимаемые государством (центральными и местными органами власти) с физических и юридических лиц в государственный и местный бюджеты

Народность — языковая, территориальная, экономическая и культурная общность

Нация — автономная, не ограниченная территориальными рамками этническая группа, члены которой привержены общим ценностям и институтам; наиболее развитая историко-культурная общность людей

Неолитическая революция — переход от охоты и собирательства к земледелию

Неравенство — неравномерное распределение материальных и духовных ценностей, разница в правовом положении людей

Норма права — это правило поведения, установленное или санкциони- рованное государством и возведённое в закон, обеспечивается госу- дарством при помощи органов государственного принуждения

Нуклеарная семья — семья, состоящая из родителей (родителя) и детей, либо только из супругов. ротивопоставляется расширенной (или сложной) семье, в состав которой входит несколько супружеских пар или как минимум несколько поколений взрослых людей

Обмудсмен — лицо, уполномоченное парламентом осуществлять контроль за соблюдением законных прав и интересов граждан в деятельности органов исполнительной власти и должностных лиц

Общество — это обособленная от природы, но тесно с ней связанная часть мира, которая включает в себя способы взаимодействия людей и формы их объединения

Община — это общность людей, связанных между собой узами кровного родства, взаимными браками, кооперацией труда, круговой порукой, совместной охраной территории

Обычай — традиционно установившийся порядок поведения людей

Обязанность — предписание действовать определённым образом

Открытое общество — общество, где перемещения из одной страты в дру- гую осуществляются свободно и не ограничены

Парламент — высший представительный законодательный орган власти, формируемый выборным путём

Патриархальная семья — семья, состоящая из нескольких поколений, с абсолютной властью мужчины как главы семейства

Подоходный налог — основной вид прямых налогов, взимаемых с доходов физических лиц (заработная плата, доплаты и премии, дивиденды, проценты и т.д.) и юридических лиц (налог на прибыль)

Политика — деятельность государственных органов, политических партий, общественных движений в сфере отношений между большими социальными группами, прежде всего, классами, нациями и государствами, направленная на интеграцию их усилий с целью упрочения политической власти или её завоевания специфическими методами

Политическая партия — политическая организация, выражающая интересы социальных групп, стремящихся к власти

Политический процесс — цепь политических событий и состояний, которые меняются с течением времени

Политический режим — система методов осуществления государственной власти и её взаимоотношений с личностью, различными социальными общностями и политическими организациями

Правовое государство — демократическое государство, в котором соблюдается принцип верховенства права; права и свободы человека и гражданина являются высшей ценностью

Правовой статус — совокупность прав и обязанностей человека

Престиж — оценка обществом или социальной группой общественной значимости тех или иных позиций, занимаемых личностью в обществе

Производительный труд — труд, создающий осязаемые продукты или предметы, являющиеся товарами

Рационализм — совокупность философских направлений, делающих центральным пунктом познания разум, мышление и рассудок

Регресс — возврат, переход от более высоких форм развития к низшим, деградация

Религия — мировоззрение и мироощущение, а также связанное с ними поведение, определяемое верой в существование Бога

Республика — форма правления, при которой глава государства избирается, а законодательная власть принадлежит выборному представительному органу — парламенту

Референдум — всенародное голосование по поводу принятия важнейших государственных решений

Санкция — мера воздействия

Семья — основанная на браке или кровном родстве малая группа, члены которой связаны общностью быта, взаимной помощью, моральной и правовой ответственностью

Синергетика — междисциплинарное направление научных исследований, задачей которого является изучение природных явлений и общественных процессов на основе принципов самоорганизации систем (состоящих из подсистем)

Синергия — это взаимодействие двух или более факторов, характеризующееся тем, что их действие существенно превосходит эффект каждого отдельного компонента в виде их простой суммы

Совесть — способность человека критически оценивать свои поступки, мысли, желания, осознавать и переживать своё несоответствие должному

Сословие — социальная группа, обладающая закреплёнными обычаями или законом и передаваемыми по наследству правами и обязанностями

Социализация — процесс усвоения индивидом социальных норм и освоения социальных ролей, продолжающийся всю жизнь

Социальная группа — любая совокупность людей, выделенных по социально значимым критериям (доход, уровень образования, профессия, возраст, пол)

Социальные классы — большие социальные группы людей, различающиеся по их месту в исторически определённой системе общественного производства, по их отношению к средствам производства, занимающие определённое место в системе общественного разделения труда и характеризующиеся специфическим способом получения доходов

Социальный статус — позиция индивида в группе или обществе

Спрос — подкреплённое денежной возможностью желание приобрести данный товар

Стратификация — расположение социальных слоёв (групп) сверху вниз по признаку неравенства в доходах, уровне образования, объёме власти, профессиональном престиже

Суверинитет — независимость государства в осуществлении своей внут- ренней и внешней политики

Тоталитаризм — политический режим, характеризующийся тотальным контролем государства над всеми сферами общественной жизни, поглощением гражданского общества, фактической ликвидацией конституционных прав и свобод граждан

Тотемизм — раннее религиозное верование, связанное с представлением о родстве между группой людей и животными

Фетишизм — религиозное поклонение неодушевлённым предметам, вера в их магическую силу

Экономика — рационально организованная деятельность больших групп людей, вступающих между собой в отношения производства, потребления, распределения, обмена товаров и услуг

Этикет — принятая в особых социальных кругах система правил поведения

Этнос — собирательное название больших по численности кровно-родственных групп людей, образующих племя, народность или нацию